helloworld: Print "Hello, World!".
greetname:  Ask a name and greet a person.
squares:    Print squares of integers between 1 and 10.
factorial:  Print a factorial of n.
swap: Swap two values
fibinacci:  Canculate Nth Fibonacci number.
odd:        Print odd numbers less than 20.
power2:     Print powers of 2.
prime:      Check if a number is prime.
primelist:  Print the list of first N prime numbers.
minmax:     Find the minumum (maximum) number in the given list.
producttable:   Generate multiplication table.
leapyear:   Check if a year is leap.
isinlist:   Check if the element is in a list.
sumofelements: Find the sum of the list elements.
guessnumber:   Guess the number.
sumofdigits:    Calculate a sum of the digits of a given number.
firstodd:   Find the first odd number
reversestring: Reverse a string
templating: Implement simple %templating% engine.
palindrome: Check if the string is a palindrome
longestpalindrome: Find the longest polindromic substring in a string.
incfilename: file1.txt -> file2.txt
sumofnumbers: Sum of numbers between 1 and n using loops and recursions.
morse: Convert a phrase to the Morse code.
morse-text: Convert Morse code to text.
longestcommon: Find the longest common substring of the two given strings.
ordergetmax: Order the elements of an array of integers to get the maximum possible number.
rotatelist: Rotate a list by N positions.
uniquenumbers: Print unique digits from a number.
pi: Print the value of pi.
removespaces: Remove extra spaces.
repeatedwords: Remove double words.


Print a list in reverse order.
Concatenate two lists.
Sort a list.
Zip two lists.

Print the list of digits in a number.

Take elements of the list at even positions
Compute running total
Compute average and sum of squares
Print a number in hexadecimal, octal and binary representations.


All possible combinations of arithmetical operations on a list.
Print calendar for a given month and year.
Tell the date of the Nth day in a year.
~ Generate an essay.

Multiply two matrices.

Rotate the matrix by 90 degrees.
